NO ./assets/amertens.xpm
WE ./assets/mberthol.xpm
SO ./assets/milamber.xpm
EA ./assets/gomerovi.xpm
DO ./assets/door.xpm
F 046,046,046
C 173,000,000

1111111
1000001
100S001
1000001
1111111