NO ./assets/amertens.xpm
WE ./assets/mberthol.xpm
SO ./assets/milamber.xpm
EA ./assets/gomerovi.xpm
F 046,046,046
C 173,216,230

        1111111111111111111111111
        1000000000110000000000001
        1011000001110000000000001
        1001000000000000D0W000001
111111111011000001110000000000001
100000000011000001110111110111111
11110111111111011100000010001
11110111111111011101010010001
11000000110101011100000000001
10000000000000001100000010001
10000000000000001101010010001
1100000111010101111101111000111
11110111 1110101 101111110001
11111111 1111111 111111111111
