NO ./assets/amertens.xpm
SO ./assets/gomerovi.xpm
WE ./assets/mberthol.xpm
EA ./assets/milamber.xpm
F 250-000-0
C 000a255a000
 
11111 
10001                                  
10N0
10001                            
11111
